Eukaryotic tree of live main groups:
Here, I will add all the relevant information about the diferent supergroups and and different subgroups (if relevant)

- TSAR:
    - Telonemia: Heterotrophic free-living flagellate
    - SAR
        - Stramenopila: 
            - Photosynthesic: Derived ultimately from a red algae.
                - Diatoms (Bacillariophyta): Unicellular/colonial with bipartite siliceous "cell walls"
                - Brown algae (Phaeophyta)
            - Heterotrophic:
                - Fungus-like: Generally parasite plants or aquatic organims
                - Flagellated: One or two flagella
                - Opalinata: two to four flagella, multiflagellated and non flagellated anaerobic Blastocystis
        - Alveolata:
            - Apicomplexa: Non-phosynthetic plastids. Parasitic (Plasmodium, Toxoplasma gondii, Cryptosporidium parvum)
            - Colpodellids: predate upon other protist or parasite them
            - Chromerids: phosynthetic
            - Dinoflagellata: autotrophs and/or grazers (many are mixotrophs)
            - Ciliophora (ciliates): (mostly) free-living heterotrophic. Most have large number of cillia. Nuclear dimorphism (somatic macronuclei and germline micronuclei)
        - Rhizaria: heterotrophic amoebae, flagellates and amoeboflagellates, spore-forming parasites, unusual algae
            - Foraminifera: 
            - Radiolarian
- Haptista:
    - Centrohelida: free-living protozoa with ray-like pseudopodia supported by microtubules (axopodia), which radiate from a spherical cell body.
    - Haptophyta: Plastid of red-algae origin 
    - Rappermonads: Unicellular algae
- Cryptista
    - Palpitomonas: Heterotrophic biflagellate
    - Katablepharida: Heterotrophic biflagellate
    - Cryptophyta: Two flagella and plastid with red algae origin
- Archaeplastida:
    - Rhodophyta: red algae --> probably better for background images
        - unicellular, uni- or multiseriate filaments, large (up to 3Â m) pseudoparenchymatous, branched or unbranched, terete (cylindrical) to foliose (blade-like) thalli, including crustose and erect forms, some of which are calcified
        - Primary marine environment, but freshwater and terrestrial lineages also occur.
        - Triphasic life --> one and two diploid phases
        - Key trait lost --> flagella, basal bodies, light-sensing phytochromes 
    - Rhodelphis: heterotrophic flagellates with a nonphotosynthetic primary plastid
    - Chloroplastida: land plants and green algae
        - Zygnematophyta: freshwater green algae with two unique characteristics: sexual reproduction by conjugation and absence of flagellate (mastigote) cells in the life cycle
        - Charophyceae (Charales): fresh and occasionally in brackish water
    - Glaucophyta: freshwater phototrophs
        - Muroplast (Chloroplasts) --> has a thin peptidoglycan cell wall 
        - Model species --> Cyanophora paradoxa --> alkaline waters, 
- Ancoracysta: Heterotrophic free-living flagellate
- Picozoa: Heterotrophic free-living flagellate
- Amorphea:
    - Obazoa
        - Apusomonada: Heterotrophic flagellate
        - Breviates: Heterotrophic flagellate
        - Opisthokonta: Animals, fungi, and their respective unicellular relatives
    - Amoebozoa: free-living (and parasites???) amoeboid forms with lobose pseudopodia (e.g., Amoeba)but also more filose amoebae, some flagellates, and various slime molds.
- CRuMs
    - Diphylleida or collodictyonids: free-living swimming flagellate
    - Rigifilida: free-living filose amoeboid cells
    - Mantamonas: free-living tiny gliding cells
- Discoba: 
    - Discicristata
        - Euglenozoa
            - Euglenida: many predatory species that glide over surfaces and algae (green algae origin)
            - Kinetoplastea: free-living or parasites flagellates
            - Diplonemea (diplonemids): 
        - Heterolobosea: Heterotrophic amoebae, flagellates or amoeboflagellates
    - Jakobida: Heterotrophic flagellates
    - Tsukubamonas: Heterotrophic flagellate
- Metamonada: Anaerobic protists. Free-living protozoa, intestinal symbionts (especially of wood-eating insects), and many parasites (e.g., Giardia, Trichomonas)
    - Preaxostyla
    - Parabasalia: 
    - Fornicata
- Malawimonadida: Free-living
- Ancyromonadida: Free-living
- Hemimastigophora: Free-living protozoa with two rows of flagella

